11111111111111111111111111111111111111111111111111
10P00000000000c00000000000000000000000000000000001
1000666600m000000077770000000000033330000000000001
100060060000000000700700000000000300300000000E0001
1000600600h000000070070000000h00030030000000h00001
1000666600w000000077770000000000033330000000000001
100000000000000000000000000000c0000000000000000001
100000c0000000000000000000000000000000000000000001
100003344300000E0000003333300000000014441000000001
100003000300h0000000003000300000000010001000000001
100003000400000s00000030003000s0000010001000000001
10000333330000000000003333300000h00011111000000001
100w00000000000E0000000000000000000000000000000001
10000000000015555511110000000771666661100000000001
10c000000000100000000100000007100000001000s0000001
100000h0000010000000010000000710000000100000000001
100000000000111111111100E0c00711111111100000000001
100000000000000000000000000007000000000000m0000001
10E0000555555555555555555555555555555550000w000001
100000050000000c000000000000000000000050000h000001
1000000000000000000000E000000000000E00500000000001
100000050000000h000000000000c000000000500000000001
10000005555555555555555555555555555555500000c00001
10000000000000000000000000000000000000000000000001
10000000w000000000000000000000E0000000000000000001
1001111100000c000000111110000000000000111110000001
1001000100000000000010001000000000h000100010000001
10010001000h000000001000100000c00000001000100E0001
1001111100000E000000111110000000000000111110000001
10000000000000000000000000000000000000000000000001
11111111111111111111111111111111111111111111111111