11111111111111111111111111111111111111111111111111
10000000000000000000000000000000000000000000000001
10001111000000000011110000000000011110000000000001
10001001000000000010010000000000010010000000000001
10001001000000000010010000000000010010000000000001
10001111000000000011110000000000011110000000000001
10000000000000000000000000000000000000000000000001
10000000000000000000000000000000000000000000000001
10000122210000000000001333100000000014441000000001
10000100010000000000001000100000000010001000000001
10000100010000000000001000100000000010001000000001
10000111110000000000001111100000000011111000000001
10000000000000000000000000000000000000000000000001
10000000000015555511110000000771666661100000000001
10000000000010000000010000000710000000100000000001
10000000000010000000010000000710000000100000000001
10000000000011111111110000000711111111100000000001
10000000000000000000000000000700000000000000000001
10000001111111111111111111111111111111100000000001
10000001000000000000000000000000000000100000000001
10000001000000000000000000000000000000100000000001
10000001000000000000000000000000000000100000000001
10000001111111111111111111111111111111100000000001
10000000000000000000000000000000000000000000000001
10000000000000000000000000000000000000000000000001
10011111000000000000111110000000000000111110000001
10010001000000000000100010000000000000100010000001
10010001000000000000100010000000000000100010000001
10011111000000000000111110000000000000111110000001
10000000000000000000000000000000000000000000000001
11111111111111111111111111111111111111111111111111
